13 24
XXXXXXXXXXXXXXXXXXXXXXXX
X|||+|||||||+||+|||||||X
X|--|-------|---|--.--|X
X|--+.......|---|--.--|X
X|..|-------|---|--.--|X
X|--|||||||||||||--.--|X
X|--|---.---|---|--.--|X
X|||+|||||||+...|||||||X
X|--|-------|------+--|X
X+||||||||||+|||||||..|X
X|----|--.---------|---X
X||||||||||||||+||||---X
XXXXXXXXXXXXXXXXXXXXXXXX
12
H 4 5 C -
H 8 9 C |
H 9 3 C .
H 17 11 C |
H 21 6 C |
T 1 1 E |
T 19 9 W |
B 14 1 W |
B 4 7 E |
B 13 7 W |
C 18 1 E |
C 8 5 E |
C 22 11 W |